33333333333311
34411311111333
34411312112113
34411323333113
34411110133113
34411313112133
33333313321213  
11312112121213
11311113111113
11333333333333
