33333333333
31111111113
31111111113
32221111113
34441111113
34241211013
34441111113
32221111113
31111111113
31111111113
33333333333