11111111113333333
11111111113114443
11111133333114443
11111131111114143
11111131133114443
11111133133114443
11111333133333333
11111312221331111
13333311212133333
33111321211131113
30121121111211213
33333312212133333
11111311111131111
11111333333331111