33333333333
31111111243
31111111243
31111011113
31111111113
31111111113
33333333333